##    ##
# #  # #
#  ##  #
#      #
#  ##  #
# #  # #
##    ##
