############   ############
#..........#   #..........#
#.%........#####..........#
#.........................#
#..........#####..........#
#..........#   #..........#
############   ############
